NO ./texure/xpm/wood.xpm
SO ./texure/xpm/wood.xpm
WE ./texure/xpm/wood.xpm
EA ./texure/xpm/wood.xpm

F 220,100,0
C 225,30,0

        1111111111111111111111111
        1000000000110000000000001
        1011000001110000000000001
        1001000000000000000000001
111111111011000001110000000000001
100000000011000001110111111111111
111101111111110111000000100011
111101111111110111010100100011111
11000000110101011100000010001
10000000000000001100000010001
10000000100000001101010010001
11000001110101011111011110N0111
11110111111101012101111010001
11111111111111112111111111111
