NO ./texure/xpm/wood.xpm




SO ./texure/xpm/wood.xpm





WE ./texure/xpm/wood.xpm



EA ./texure/xpm/wood.xpm



F 220,100,0

C 225,30,0

                      11111111111111111111111111
                     10000000000110000000000001
                    1011000001110000000000001
        11111111111 1001000000000000000000001
1111111110110000011100000000000011111111111
100000000011000001110111111111111
11110111111111011100000010001
11110111111111011101010010001      1111
110000001101011011100000010001     101
10000000000000001100000010001     1111
10000000000000001101010010001
11000001110101011111011110N0111
11110111211101012101111010001
1111111121111111211111111

