NO ./texure/xpm/wood.xpm
SO ./texure/xpm/wood.xpm
WE ./texure/xpm/wood.xpm
EA ./texure/xpm/wood.xpm

F 220,100,0
C 225,30,0
            111111111111111111111111
                10000000000000001
                10000000000000001
                10000000000000001
                10000000W00000001
                10000000000000001111111111111
                10000000000000000000000000001
                11111111111111111111111111111
                