NO ./texure/xpm/wood.xpm
SO ./texure/xpm/wood.xpm
WE ./texure/xpm/wood.xpm
EA ./texure/xpm/wood.xpm

F 220,100,0
C 225,30,0










                                                       
              
                11111111111111111           
                10000000000000001       
                100000000E0000001       
                10000000000000001
                11111111111111111

